10 10
...#...#..
#.#..#.#..
#.#..#.##.
....#.....
##........
....#...#.
#####.....
.###..####
......#...
###.......
